##################################################
#S         #   #             # ## #  #     ###   #
######## ## # # ###### ## ##      # # ## ## #  # #
#      #             # # # ######            #  ##
# ##### ############ #           ######### # # # #
#                  # # ### ##### #        ## #   #
# #### ##### ##### # # # ## #  # # ###### #  # # #
# #   #    # #   # # #       # # # #    #  # # # #
#  # ## ## # # # # #  ## # #   # # #E## # #  # # #
# ##    #  # # ### # ## # # #### # ####    # # ###
#  # ######  #     #             #    # # #  #   #
# #        #  # ### ### ######### ### ###  # # # #
# # ###### # ## #      #                ## # # # #
# # #    # # #  ## ### # # # ## ##### # #  # # # #
# # #### # #  #    #   ## # # # #     ## ### # # #
# #      # # # ##### #          ## ###       # # #
# ######## #        ############   # # ########  #
#          ## # # #  #          ## # # #     #  ##
########## # # # ## #  # ### ## #  # #  # # # #  #
#        # #     #   #  ##  #    # # # #  ##    ##
## ##### # # ### ## #  #   # ## #  # #  #  # ## ##
#  #     # # #   #   # # #    #  #   # #  #  #   #
## ####### # ####  # # # # ## # # ## # ## ##  # ##
##         #     # # # # #  # # # ## # ##    #   #
### ## ## ## ### # # # # # #  # #    #  # ##  # ##
#### # #  #    # # # # # #  # # ###### #  #  #   #
# ## #  # #### # #  #  # # #  #        ###### # ##
#      ##    ### # # # ###  #  # # # ##         ##
# # # #   ##     #         #  ###  #    # # ## ###
##################################################