##############################
#S##    #    #       #     # #
#    ##  # #   # ##### # #   #
#####  #  #####         #  # #
#     # #  #   # # ####  #  ##
## ##   # #  #  #     ##  #  #
#  # # ##   #  #  # #  ###  ##
# #  #   # #  #  #   ##    # #
#   # ##  #  # ##  ##   ##   #
# ##   # #  #     #   ##  ## #
#    ###  #  # # #### #  ### #
## ##   # ##  #   #   ##  #  #
# #   # #   #  ###  ## ## # ##
#   ##  # #  # #   ##   #   ##
# #   #  #  ## # ##   # # ## #
##  #  #   #   # # #E#  #    #
#  # #  # #  ###    # #  ### #
# #   #  #  ##   ##    #     #
#  ##  #  # #  #   ###  ### ##
## #  # #   ### # #   #    # #
#  # #   ###     ## # ## #   #
# #    # #   ###    #   ## # #
#   ###    ##   ###  ##   #  #
####   ## #   #   # #  ##  # #
#    #   ## # ###  #  #   #  #
# ##  ##    #   ##   # ## # ##
#   # # ## # ##   # #       ##
# #  #    #   ### ##  # ###  #
#  #   ##   #   #    #     # #
##############################