##########
#S#    # #
# E# #   #
## # ## ##
##  #   ##
#  #  #  #
# #  # # #
# ## # # #
#    #   #
##########