##################################################
#      #                    #    # ##           ##
# #### # ## # ### ##### ### # ##      # ## ## #  #
# #  # # # # #  #      #    # # ######## # # # ###
#  # # #       # # # # # ## #         #  #       #
# #  #  # #### #  # #  ###   ######## # ######## #
#  # # # #   #  #    #    # #       # #  #     # #
# #  # # # # # #  ## #### # # ##### # # ## ### # #
# # ## # # # # ### #    # #  #      # #      # # #
# #      # # #      # # # ## ## #####  ####### # #
# # # #### #  ##### ### #  #  # #     #        # #
# #  #     # #    #      #  # # # ##### ## # # # #
# # #  ### #   ##   ###### #  # # #     # # ## # #
# #  #    # ### # ##       ## # # # ####      #  #
#  # # # #       #   ## # #   # # #    # ####  # #
# ##  ## # ## ## # #   # # ##   # # ## # #   # # #
# #  #   # # # # # # ##      # #  #  # # # ###   #
#  # # ### #   # # #  # #### #  # # #  # #    ## #
# #  # #   ## #  # # #  #  #  # # #  # #  ###  # #
#  ### # ## # ## # #  #  # # #  # # #  # #   #   #
# #    # #       # # #  #  #  # # ### #  # # ### #
# # # #  # # # # ###  # # #  #  #     ## # #    ##
# # #  #  # # #      #    ##  ## ## #  # #  ###  #
# #  ### #     # #### # #  # #   # ## #  # #  # ##
# # #    # ###  #        ### # #       # # # #   #
#   # #### # # #  #######    #  ### ###      ## ##
# ### #      #  #       # #### #   #   #####  #  #
##    # # ## # #  # # # # #    # # # #      # # ##
#  ## # #   #  ##  # # ## # ###  # #  ##### # #  #
##  # #  #### #   #       # #  # # # #    # ### ##
#  #  # #     # # # ##### #  #   # # # ####      #
## #### # # # # # # #   #  # ##### # #     ##### #
#       # #  #   #  # ### #        #  # ## #     #
########   ### #  # #      # # # # # #   # # #####
#       # #    ####  #######  # # ##  # #  # #   #
# ## ## # # ###     #        #       #   # # # # #
# # # # # # # # # # # ###### # ###### #### # # # #
# #   # # # # # ## ## #     ## #           # # # #
# # # # #     #        # # #   # ### # # # # # # #
# # # #  ##### #### # #  # # ##  # # # ## ## # # #
# # # # #          #  ## # # # # # #  #      # # #
# #  #  # ## ##### # #   # # # # # # #  ###### # #
# ##  # #   #    # # # #  ## # # # #  # #      # #
#  # #  # ##  ## # # # # #   #   # # #  ##### #  #
## # ## #   #  # # #   # # ##  ##  #  #      # # #
#  #    # # # ##   ## #  # # # #  #  # ##### #   #
## # ## # # #   # #   #### # #  #  #       # # # #
#  ###  ### # ## # ###     # # ## # ###### # ### #
##    #     #          ## #              #       #
##################################################