##################################################
#S#                      #                       #
# # ## # # # # # # # # # # ## # # # # # # # # ## #
# # # # # # # # # # # # ## # # # # # # # # # # # #
# #                                            # #
# ####################################### #### # #
#                                        #   # # #
########################### # # # # # ## # # # # #
#                          # # # # # # # # ### # #
# #################### # #             # #     # #
# #                   # # ############ #  ###### #
# # ## # # # # # # ## #              # # #       #
# # # # # # # # #   # ############## # # # #######
# # #            # #                 # # #       #
# # # # # # #### #  #################  # ####### #
# # # ## # #   # # #                 # #         #
# # #        # # # # ########## # ## #  # # # ## #
# # ######### ## # # #        ## # # # # # # # # #
# #              # # # ## # #      #           # #
# ################ # # # # # ###### ########## # #
#                  # #                         # #
################## # # ## ###################### #
#                # # # # #                       #
# ############## # # # # # #### ##################
# #           E# # # # # # #   #                 #
# # ############ # # # # # # # # ####### ####### #
# #              # # #   # # #         # #     # #
# ################ # ##### ## ########## # ### # #
#                  #                     #   #   #
##################################################