##############################
#S  ##  #   #     #          #
# #    #  # ## ##  # #### ## #
## ###   ##    #  #  #  #  # #
#  #  #### ###### # ## # # # #
##   #         #  #      #  ##
#  ##  ## # # ## ### ###  #  #
# ##  #   # ##   ## #   # ## #
#    # # ##  # ##    # #   # #
# ###  #   ##  # # # #   ### #
# #   # ## #  ##   # # ##    #
# # #   #  # #   ##   #   # ##
# # # #  # #  # #  ##  ## #  #
#   #  # # # ##  #   #  #  # #
#### #  #  #    ### # #  # ###
#  #  # # # ## #E#  #   #    #
##   #  # # # #   #   # # ## #
# # #  ##     # #  # #  # #  #
#   # #  ### #  ##  #  #  # ##
# ##  # #  #  #   # # #  #   #
#   #   ##  #  ## #   # #  # #
# #  ##   #  # #  ## # ##### #
# # ## ##   ##   #  #   #    #
# #    # ## # ### #   # # ## #
# # ###   # #      # ##   ## #
# #     # # # # # #  # ###   #
##  # ##  # #  #    ##    ## #
#  #   # #   ##  ####  ##    #
# #  # #   #    #     #   # ##
##############################