##############################
#S##    #    #  #       # ## #
#   # #   # #  #  # # #      #
### #  ## #   #  #   # #### ##
# #  # # # ##  #  ###        #
#  #   #     # # #    ###### #
##  ###  ###E  ##  ###       #
#  #  # #   # #   #  # #### ##
##   ## # #  #  #  #   #   # #
#  ##   #  # # #  #  ### #   #
##    ## # #  #  # #    ## # #
#  ###     ## # ##  ###    # #
# #    # ##   #   #    # ##  #
# ## # #  # ## ##  # #  # # ##
#   ## # #  #   # ##  ##     #
### #  #  #   # #   #    # # #
# #  # ##  ###  # #  # #  # ##
#   #   # #   #  # # #  ##   #
## # ###   # # # #   ###   # #
#  #    ## # # # # #     # # #
# #  ##  # #   # # ######  # #
#   #   #  ## #  ##      # # #
#### # ## #     #   ## # # # #
#    # #  # # ##  ## # # # # #
### ##   # #  #  #    #  ### #
#   # ###  # #  # # #   #    #
# ##     # # # #   #  # # ## #
# #  # ##      # #   #    ## #
#   #     # # #   # #  # #   #
##############################