####################################################################################################
#S              # #                 #                 #E          # ## ###            # # # # # # ##
## # # # # ####   # ####### ####### # ### # # # ## # # # # # # ##        # ##########              #
# # # # ###   # # # #     # #  #  # # # # ## # # #  #   # # # ########## # #        ####### ###### #
#          # #   #  # # # # # # # # # # # #        #  #               #  # # # ## #  #     #     # #
## # # ### #  # # # # ####  # #     # # # # ### ### # ###### ########  # # # # # ## #  # ### # # # #
###  # #     #  # # #   ### #   # # # # # # #  #            #       # #  # # # #     # #     # # # #
## #### ## ## # # # # #  #  #### #  #   # #  # # ####### ## # # ## #   # # ##  ####### # ## ###  # #
#             # # # # # # #       # ##### # #  # #      #   # ## # ## ## #   #         # # # ## ## #
# # #### ## # # # # # #    ###### #       # ## # # ### #### #    #       # ## ##########       #   #
#  #     # # ## # # # # ## #    #  #######   #     #  #     ##############               ## ## # # #
# #  # ##       # # # #  # #### # #       # # ###### # #### #             ## ##### ####### ## #  # #
# ### ### ######  # # # #       # # ### # #               # # ######### #   #    # #           # # #
#       # #      #  # # # ####### #    #   ############## # # #    #   #  # ### ## # #### # ## # ###
# # ### #  # #### # ### ##        # ##  # #             # # # ### ### # # #     #  # # ### # # #   #
# #   # # #              # # # # #  #  #  # # # # #### #  #              ## #### # # #       #  ## #
#  #### # # # ############  #   # #  #  # ## # ## #     #  ############## #        #  ## ### # #   #
# #     # # ##  #          ###### ###  #          # ### # #                # ## # #  #   #   # # # #
# # ### # #   # # ## # ## #          # ############   # # ## ## # ### #### #### #  #  ## ##### # # #
##  # # # # #   # # # # # # ## # ### #          # #### ##  # # ###   #   #   #   # # #         ### #
### # # # #  ## # #     # # # ##   # # # # ### #          #     # # # ## # ## ### ## # ########    #
### #   #  ## ### #####   # #   ## #  # # # #  # ######### #### #                    #          # ##
#   # ### ##           # ## # #  ##  #       # # #            # ############ ####### ## # ### ###  #
# # #   #  # ######### #  # # # # ## # ### # # # # # # ### ## #             #       #   # # ##  # ##
### ##### #  #       # # ## # #    # # #  ## # # #  #  ## # # ## ## # # # #  # # # # #####     #  ##
#         ## ####### # # #  # # # #  # # # # # # # # # #    # #    #  ####  #  # ##        # #  #  #
# ########           # # ## # #  # # # #   # # # ##     ## #  ##### #     #  # #  # # ##### ## #  ##
# #     # ######## # # # #  # # #  # # # ###   #  # ## # # ##        #### # #   ##   #         ##  #
# # ###           # #  #  # ###  # # # #     # # #  #  #      # # ## #    #  # ## # #  ## # # #  # #
# #   # # # ##### #  # ####     ## # # ###### #   #  # ######### #   # ###  #     #  #   #  ## # # #
# #####  # #    # # ## #    # #    # #         # #  ##            ## # #  #  # #### #  #  #      # #
#       #   # # # #    # ##### ##### # # ##### #  #   ########### #  #  # # ##      ## # # ####### #
###### #  # # # # # ## # #           # ##      # #  #           #  # # #  # # # #### # ##          #
#    ## # #   # # # #  # # #### #####   # ## # # ### ###########  #  # ## # #  #        # ## # # ###
# ##    # # # ##  #  # # # #   #     # #   # # #               ##  # # ## # # #  ###### # # # # ## #
## # # ## # #   # # #  # #  # ## ### #  # #  ## ############ # #  #  #    # # ## #   ## # #        #
#    ## # # # # # # #### # #     #   # #   #                #   #  # ###### #    # ##   # # #### # #
# ##      # #  #  #      #  # ### ####  # # ###### # # # ## ## #  #         # ## #    # # # #  # # #
### ####### # # #  ## ###  #           ##         # # ### #  #  # ###### ###  #  ######## #  # # # #
#           # # # #      # # ###### #### ### ## # #       # #  #  # #   #   #  #          # ## # # #
# # ######### # # ######## # #     #        ## #  # # # # #  #  # # # ### # # # # ## # # #     # # #
#  #          # #          # ##### # # # # #    # # # # # # #  #  #       # # #  ## # # # ## # # # #
# #  #########   #### ## ###         ##  ## ### # #  ## # #  # ##  ######## # ##            ## # # #
#  #           #   # #  # # ######### ##        # # #   ### ## #  #         # #  ####### ## ## # # #
# ############# #### # #            # # ####### #  #  ##     # ## # ## ## # #  # #      # # #  # ###
#                      # ##########             # # # ## ## ##    # # # # # # ##  # ###     ###    #
# # # # # # # ## ## # #  #         #############  #      #   # ###  #      ##    # #  # # #    # # #
# ## ## ## ### # # # # # ######## #            ## ####### ####  # # #######   # #    ## # # ## ### #
#    #     ##                       # # # # ##  #              #            #  ## ##     #   #     #
####################################################################################################