####################
#S             #  ##
## # ######### # # #
### #     #  # #   #
#   # # # # ## # # #
# # # # # # #  # ###
# # # # # #  # #   #
#E# # # #  # # # # #
##  # # # ## # # # #
### # # #    # # # #
#   # #  # # # # # #
# # # # # ## # # # #
# # # # #    # ### #
# ### # # # ##     #
#     # ## # ##### #
# # ###          # #
# #    ######## ## #
#  # #        #    #
# #   # # # #  ### #
####################