####################
#S          #E  #  #
# # # # ###  ## ## #
## # # #  # ###    #
#        #   # # # #
# ### ##  # #   #  #
# # #### #  # #  # #
# #       # # # ## #
# #########  #     #
#           ## #####
# ##########       #
# #          # # # #
# # # # # ### # ## #
# ## ### #         #
#         # ###### #
####### # # #    # #
#      #  # # ##   #
## #### # # ### # ##
##               ###
####################